╔════════════╗p
║············│p
║·┌──┐·┌───┐·│p
║·│ii│·│iii│·│p
║·└──┘·└───┘·└p
║·············p
║·┌──┐·┌┐·┌───p
║·└──┘·││·└──┐p
║······││····│p
╚────┐·│└──┐ │p
eeeee│·│┌──┘ └p
eeeee│·││     p
eeeee│·││ nhh_p
╔────┘·└┘ uiiip
#     ·   uiiip
╚────┐·┌┐ uiiip
╔────┘·││ vhhhp
#     ·││     p
╚────┐·││ ┌───p
╔────┘·└┘ └──┐p
║············│p
║·┌──┐·┌───┐·│p
║·└─┐│·└───┘·└p
║···││········p
╚─┐·││·┌┐·┌───p
╔─┘·└┘·││·└──┐p
║······││····│p
║·┌────┘└──┐·│p
║·└────────┘·└p
║·············p
╚═════════════p
