┌────────────┐p
│············│p
│·┌──┐·┌───┐·│p
│·│  │·│   │·│p
│·└──┘·└───┘·└p
│·············p
│·┌──┐·┌┐·┌───p
│·└──┘·││·└──┐p
│······││····│p
└────┐·│└──┐ │p
     │·│┌──┘ └p
     │·││     p
     │·││ ┌──_p
┌────┘·└┘ │   p
#     ·   │   p
└────┐·┌┐ │   p
     │·││ └───p
     │·││     p
     │·││ ┌───p
┌────┘·└┘ └──┐p
│············│p
│·┌──┐·┌───┐·│p
│·└─┐│·└───┘·└p
│···││········p
└─┐·││·┌┐·┌───p
┌─┘·└┘·││·└──┐p
│······││····│p
│·┌────┘└──┐·│p
│·└────────┘·└p
│·············p
└─────────────p
