Pacman, Pa, 3, 3
|
#####
#...#
#...#
#..P#
#####
