0, Pa, Pacman, 7, 7
0, Ga, Ghost, 2, 7
1, Pb, Pacman, 1, 1
1, Gb, Ghost, 6, 1
|
#########
#.......#
#O##.##.#
#.##.##.#
#.......#
#.##.##.#
#.##.##.#
#.......#
#########
